ah	ah
eh	eh
ae	ae
ee	ee
oe	oe
ih	ih
oh	oh
oo	oo
ou	ou
uh	uh
en	en
in	in
un	un
on	on
b	b
d	d
f	f
g	g
k	k
l	l
m	m
n	n
p	p
r	r
s	s
sh	sh
t	t
v	v
z	z
j	j
y	y
w	w
uy	uy
ng	ng
