a	a
b	b
B	B
ch	ch
d	d
D	D
e	e
f	f
g	g
G	G
gn	gn
i	i
I	I
j	j
k	k
l	l
ll	ll
m	m
n	n
o	o
p	p
r	r
rr	rr
s	s
t	t
u	u
U	U
w	w
x	x
y	y
Y	Y
z	z
