b	b
ch	ch
d	d
f	f
h	h
j	j
kk	kk
k	k
l	l
m	m
n	n
ng	ng
pp	pp
p	p
r	r
s	s
tt	tt
t	t
w	w
y	y
A	A
E	E
I	I
O	O
U	U
Ua	Ua
a	a
au	au
e	e
i	i
ia	ia
o	o
u	u
ua	ua
B	B
D	D
K	K
W	W
Y	Y